2021 11 16   1 5 2 4 4
2021 11 17   4 0 2 4 4
2021 11 18   5 5 1 3 1
2021 11 19   1 1 2 3 1
2021 11 20   1 0 2 3 2
2021 11 21   2 3 0 2 0
2021 11 22   7 0 3 0 4
2021 11 23   2 5 3 1 4
2021 11 24   3 3 2 3 3
2021 11 25   4 3 3 5 3
2021 11 26   7 2 2 3 2
2021 11 27   9 5 1 1 3
2021 11 28   6 5 2 0 3
2021 11 29   6 4 2 4 3
2021 11 30   6 3 2 3 0
2021 12  1   0 0 1 3 3
2021 12  2   9 5 0 4 1
2021 12  3   0 4 0 5 3
2021 12  4   4 3 2 1 2
2021 12  5   8 2 2 3 1
2021 12  6   3 5 3 0 4
2021 12  7   0 3 2 5 1
2021 12  8   1 5 0 4 0
2021 12  9   9 5 1 3 2
2021 12 10   6 0 1 0 0
2021 12 11   7 3 2 5 2
2021 12 12   0 4 1 4 1
2021 12 13   0 3 3 1 2
2021 12 14   7 5 1 3 0
2021 12 15   9 1 2 5 3
2021 12 16   2 4 2 4 3
2021 12 17   8 0 3 0 0
2021 12 18   0 5 0 5 3
2021 12 19   3 1 1 2 0
2021 12 20   1 2 2 4 1
2021 12 21   1 0 3 0 4
2021 12 22   1 0 1 1 3
2021 12 23   8 0 0 1 2
2021 12 24   8 1 0 1 2
2021 12 25   1 0 1 1 4
2021 12 26   9 2 3 3 0
2021 12 27   9 1 0 4 3
2021 12 28   4 4 0 5 4
2021 12 29   2 3 1 3 3
2021 12 30   3 3 2 5 3
2021 12 31   0 0 2 0 1
2022  1  1   8 5 1 2 4
2022  1  2   7 0 2 4 2
2022  1  3   8 5 2 5 3
2022  1  4   1 3 0 4 1
2022  1  5   2 0 0 3 3
2022  1  6   6 4 2 5 3
2022  1  7   9 0 0 0 1
2022  1  8   8 2 3 1 4
2022  1  9   7 0 0 5 0
2022  1 10   2 2 2 3 4
2022  1 11   1 0 1 3 0
2022  1 12   3 4 1 2 0
2022  1 13   8 4 1 3 2
2022  1 14   2 5 2 5 4
2022  1 15   6 3 0 0 0
2022  1 16   5 2 1 1 2
2022  1 17   5 0 2 3 4
2022  1 18   3 1 0 1 4
2022  1 19   9 1 2 1 3
2022  1 20   5 3 0 2 0
2022  1 21   8 4 3 0 4
2022  1 22   1 2 3 2 3
2022  1 23   3 1 1 1 2
2022  1 24   8 2 1 5 1
2022  1 25   1 4 2 4 1
2022  1 26   4 0 2 1 1
2022  1 27   5 2 1 2 4
2022  1 28   9 0 3 3 4
2022  1 29   4 2 1 3 1
2022  1 30   3 4 2 2 3
2022  1 31   7 5 2 5 2
2022  2  1   5 5 2 2 4
2022  2  2   4 2 0 5 3
2022  2  3   0 5 1 0 2
2022  2  4   3 2 3 4 2
2022  2  5   5 0 0 5 2
2022  2  6   2 1 3 3 3
2022  2  7   4 1 0 5 1
2022  2  8   3 0 1 5 0
2022  2  9   1 2 2 2 1
2022  2 10   4 4 3 2 3
2022  2 11   4 2 2 1 3
2022  2 12   1 2 0 5 0
2022  2 13   0 2 2 1 4
2022  2 14   9 1 0 4 3
2022  2 15   2 1 2 4 3
2022  2 16   1 2 2 0 4
2022  2 17   2 4 3 4 1
2022  2 18   0 5 2 5 1
2022  2 19   7 1 2 0 4
2022  2 20   2 4 1 1 2
2022  2 21   4 3 3 1 3
2022  2 22   3 2 2 4 3
2022  2 23   6 5 1 1 0
2022  2 24   4 4 2 4 0
2022  2 25   6 1 3 3 2
2022  2 26   3 4 2 2 3
2022  2 27   3 2 3 2 4
2022  2 28   0 1 2 4 0
2022  3  1   7 5 0 0 4
2022  3  2   3 4 1 2 2
2022  3  3   8 5 3 1 0
2022  3  4   0 0 1 0 0
2022  3  5   0 1 0 1 1
2022  3  6   2 4 3 1 1
2022  3  7   6 0 1 0 2
2022  3  8   7 3 1 3 1
2022  3  9   2 1 0 3 1
2022  3 10   5 5 3 3 4
2022  3 11   5 1 0 0 0
2022  3 12   3 0 0 4 4
2022  3 13   2 1 1 2 3
2022  3 14   7 5 3 1 2
2022  3 15   8 1 2 3 2
2022  3 16   4 1 1 3 4
2022  3 17   5 5 2 0 4
2022  3 18   5 1 2 4 4
2022  3 19   1 1 2 5 4
2022  3 20   6 1 0 1 2
2022  3 21   8 5 0 1 1
2022  3 22   5 3 2 2 1
2022  3 23   7 0 2 0 3
2022  3 24   6 1 0 1 0
2022  3 25   2 2 2 3 2
2022  3 26   2 5 1 5 0
2022  3 27   8 5 2 3 4
2022  3 28   0 1 1 0 1
2022  3 29   0 0 2 5 4
2022  3 30   2 3 0 1 3
2022  3 31   9 3 0 0 2
2022  4  1   9 0 1 1 2
2022  4  2   1 5 0 3 4
2022  4  3   1 5 3 1 3
2022  4  4   2 0 1 4 4
2022  4  5   0 4 3 4 0
2022  4  6   6 0 2 5 2
2022  4  7   4 5 1 1 1
2022  4  8   3 4 3 3 0
2022  4  9   4 0 3 3 1
2022  4 10   4 0 0 0 0
2022  4 11   5 3 3 4 3
2022  4 12   7 0 0 1 4
2022  4 13   3 5 1 2 1
2022  4 14   8 5 2 5 0
2022  4 15   9 2 1 0 0
2022  4 16   8 4 2 1 3
2022  4 17   2 4 0 1 0
2022  4 18   3 3 3 5 2
2022  4 19   0 5 3 3 3
2022  4 20   3 3 0 3 2
2022  4 21   9 3 1 1 3
2022  4 22   2 2 0 5 3
2022  4 23   4 2 2 0 4
2022  4 24   3 4 0 4 2
2022  4 25   6 5 3 0 0
2022  4 26   8 1 1 4 3
2022  4 27   3 5 1 4 4
2022  4 28   5 2 2 1 0
2022  4 29   5 5 1 4 4
2022  4 30   5 0 2 5 3
